A
凹  	mmgd
敖  	gqty
B
拜  	rdfh
犇  	rhth
敝  	umit
C
曹  	gmaj
长  	tayi
乘  	tuxv
囱  	tlqi
丑  	nfd
垂  	tgaf
D
亣  	yji     	dà
丹  	myd
段  	wdmc
F
甫  	gehy
G
干  	fggh
甘  	afd
贯  	xfmu
H
亥  	yntw
互  	gxgd
囬  	mjdd    	huí
J
己  	nngn
巳  	nngn
旡  	aqv     	ji
戋  	gggt
乆  	nwi     	jiǔ
卷  	udbb
K
卡  	hhu
L
耒  	dii
离  	ybmc
〇  	llll
了  	bnh
龙  	dxv
M
毛  	tfnv
矛  	cbtr
么  	tcu
眉  	nhd
免  	qkqb
面  	dmjd
芈  	gjgh    	miē/mǐ
乜  	nnv     	miē/niè
末  	gsi
N
年  	rhfk
牛  	rhk
P
爿  	nhde    	pán
叛  	udrc
Q
千  	tfk
曲  	mad
S
身  	tmdt
市  	ymhj
巳  	nngn
亖  	fff
T
凸  	hgmg
W
万  	dnv
卐  	nghg/hngg
卍  	nhgh    	wan
为  	ylyi
未  	fii
我  	trnt
乄  	nyv     	wu
午  	tfj
舞  	rlgh
戊  	dnyt
X
象  	qjeu
Y
丫  	uhk
牙  	ahte
襾  	gmjg    	yà
彦  	uter
羊  	udj
养  	udyj
尧  	atgq
曳  	jxe/jnte
乙  	nnll
尤  	dnv
于  	gfk
予  	cbj
禺  	jmhy
彧  	akge
甴  	kghk    	yóu
曱  	kghk    	yuē
戉  	anyt    	yuè
Z
臧  	dndt
兆  	iqv
追  	wnnp

================

一  	ggll


幵  	gdf/tdfh
扌  	rghg
匸  	aghg
耂  	fte'

艹  	aghh
卄  	aghh
卝  	gjgd

朩  	sghy
覀  	sghh
丆  	dgte

尢  	dnv

丨  	hhll    	gun
亅  	hhll    	gun
虍  	hav
刂  	jhh
氺  	ihyy


忄  	nyhy

尐  	iyi     	ji
冂  	mhn

罒  	lhng
罓  	mqi'

丿  	ttll

钅  	qtgn
牜  	rhk
  	
攵  	ttgy

亻  	wth

彳  	ttth    	chī
彡  	ettt
乂  	qtyi
釒  	qqqq
乊  	tue
飠  	wyvc
爫  	etyt
勹  	qtn

厃  	qdr
犭  	qte
饣  	qnb

丶  	yyll    	zhu
亠  	yyg
冫  	uyg
訁  	yyyy'
丬  	uygh
疒  	uygg
丷  	uyte


  	oopb
氵  	iyyg
灬  	oyyy
宀  	pyyn
冖  	pyn

辶  	pyny
讠  	yyn
礻  	pyi

乚乛乀乁	nnll

彐  	vngg
肀  	vhk

凵阝卩	bnh
丩  	nhk

屮  	bhk
卪  	byi'    	r
厶  	cny

廴  	pny
癶  	wnyt/wnyy

巜  	vvn
纟  	xxxx
糸  	xiu
糹
  	xyxy 
巛  	vnnn

================

䓬䓝䂬
